wwwwwwwwww
w-----*--W
w-P---*--W
w-----*--W
w--------W
w------G-W
wwwwwwwwww
