WWWWWWWWWWWWW
W...........W
W.....P.*...W
W...WWWWW...W
W...........W
W........G..W
WWWWWWWWWWWWW